111111111111111111111111111111111
10000000M000000P0C000000000000001
101111110100001000011111101000101
101000000100001000010000001001001
10111111010000100001000C001110001
101000000100001000010000001001001
101000000111111000011111101000101
1000C000M0000000000C0000000000001
101000010001111110000010000100001
101000010001000010000010000100001
101000010001000010000010000100001
101111110001000010000C10000100001
100000010001000010000010000100001
1000C0010001000010000010000100001
1000000100010000100000100E0100001
101111110001111110000011111100001
111111111111111111111111111111111