1111111111111111111111111
10M10000000C0C0C0C0C0C0C1
1000011111000000000000001
1P0011E000000000000000001
1111111111111111111111111