1111111111111111111111111111111111111111111111111
1000000000000000000000000000000P00C0E000111111111
1011110100100000101001000000011100100000101000001
1010010011111010001001000000010100010000100100001
1000010000000000000000000000010000000000100000001
1000010000000000100000000000010000000000100000001
1010010000100000101001000000010100100000101000001
1000011111101111101001000000011100010000100100001
1000000000000000000000000000000000000000100000001
1111111111111111111111111111111111111111111111111
1111111111111111111111111111111111111111111111111
1000000000000000000000000000000000C0000010C000001
1011110100100000101001000000011100100000101000001
1010010011111010001001000000010100010000100100001
1000010000000000000000000000010000000000100000001
1000010000000000100000000000010000000000100000001
1010010000100000101001000000010100100000101000001
1000011111101111101001000000011100010000100100001
1000000000000000000000000000000000000000100000001
1111111111111111111111111111111111111111111111111
1111111111111111111111111111111111111111111111111
1000000000000000000000000000000000C0000010C000001
1011110100100000101001000000011100100000101000001
1010010011111010001001000000010100010000100100001
1000010000000000000000000000010000000000100000001
1000010000000000100000000000010000000000100000001
1010010000100000101001000000010100100000101000001
1000011111101111101001000000011100010000100100001
1000000000000000000000000000000000000000100000001
1111111111111111111111111111111111111111111111111