11111111111111111111111111111111111111111
100000000000000C00000C00000000000000E1001
10100101001000001010010000000101001001001
10100100101010100010010000000101000101001
1P0000000C00C0000000000000000000C000C1C01
11111111111111111111111111111111111111111